Tanggal,Keterangan,Debit,Kredit,Saldo
04/22/2024,         Penjualan ,,280000,280000
04/23/2024,         Penjualan ,,280000,560000
04/24/2024,         Penjualan ,,280000,840000
04/25/2024,         Penjualan ,,280000,1120000
04/26/2024,         Penjualan ,,280000,1400000
04/27/2024,         Penjualan ,,280000,1680000
04/28/2024,         Penjualan ,,280000,1960000
04/29/2024,         Penjualan ,,280000,2240000
04/30/2024,         Penjualan ,,280000,2520000
